0,0xFFFFFF 0,0xFFFFFF 0,0xFFFFFF 0,0xFFFFFF 0,0xFFFFFF
0,0xFFFFFF 1,0xFFFF00 1,0xFFFF00 1,0xFFFF00 0,0xFFFFFF
0,0xFFFFFF 1,0xFFFF00 2,0xFF0000 1,0xFFFF00 0,0xFFFFFF
0,0xFFFFFF 1,0xFFFF00 1,0xFFFF00 1,0xFFFF00 0,0xFFFFFF
0,0xFFFFFF 0,0xFFFFFF 0,0xFFFFFF 0,0xFFFFFF 0,0xFFFFFF
